
SO xpmfile/SO.xpm
NO xpmfile/NO.xpm
WE xpmfile/WE.xpm
EA xpmfile/EA.xpm


C 55,16,88
F 128,128,128



111111111111111
1S0000000000001
111111000111111
100000000000001
100000000000001
100000000000001
100000000000001
100000000000001
111111000011111
100000000000001
111111111111111



