NO parsing/xpmfile/NO.xpm
SO parsing/xpmfile/SO.xpm
WE parsing/xpmfile/WE.xpm
EA parsing/xpmfile/EA.xpm

F    22,200   ,    0 

C   225  ,  25   ,0                 


1111111111
1000000001
1000000001
1000S00001
1111111111
