SO xpmfile/SO.xpm
NO xpmfile/NO.xpm
WE xpmfile/WE.xpm
EA xpmfile/EA.xpm





C 0,0,0
F 80,80,80


111111111111111111111111111111
100000010010000010010000010011
110000000000000000000000000001
100000000000000000000000000001
10000000S000000000000000000001
100000000000000000000000000001
100000000000000000000000000001
100000000000000000000000000001
100000000000000000000000000001
100000000000000000000000000001
100000000000000000000000000001
100000000000000000000000000001
111111111111111111111111111111

