
SO xpmfile/SO.xpm
NO xpmfile/NO.xpm
WE xpmfile/WE.xpm
EA xpmfile/EA.xpm


C 50,50,50
F 0,0,0



111111111111111
100000000000001
100000011111111111111111111111111111111111111111111111111
100000010000000000000010000001000000001000000010000000001
100000010000000000000000000000000000001000000010000000001
100000010000000000000010000000000010001000100010001000001
111011111110011111111110000000000010001000100010001000001
11000011000001        10000000000010001000100010001000001
10000001000001        10000000000010000000100000001000001
10000001000001        10000000000010000000100000001000001
100000000000011111111110000000000011111111111111111001111
10000001000001000000000000000000001               1001
1000000100000100000S00000000000000111111          1001
1100001100000100011000000000000110001001          1001
1111111111111100010000000000000010001001          1001
             100000000000000000000001001          1001
             100000000011110000000001001          1001
             10000000001  10000000000001          1001
             10000000001  1000000000100111111111111001
             10000000001111000000000100000000000000001
             10000000000000000000000100111111111111111
             100010000000000000010001001
             100011000000000000110001001
             100000000000000000000001001
             111111111111111111111111111
             