





SO xpmfile/SO.xpm
NO xpmfile/NO.xpm
WE xpmfile/WE.xpm
EA xpmfile/EA.xpm




C 0,0,0
F 0,0,0








     111111111111111                 111111111111111
     100000111000001                 100000111000001
     100000010000001                 100000010000001
     100000000000001                 100000000000001
     10000000000000111111111111111111100000000000001
     10000000000000000010001010001000000000000000001
     10000001000000000010001010101000000000010000001
111111000001110000000001000100010100000000011100000111111
1000000000111110000000000101S1010000000000111110000000001
101111000001110000000001010001000100000000011100000111101
101  10000001000000000010101010001000000000010000001  101
101  10000000000000000010001010001000000000000000001  101
101  10000000000001111111111011111111100000000000001  101
101  10000000000001        101       100000000000001  101
101  10000001000001        101       100000010000001  101
101  10000011100001        101       100000111000001  101
101  11111111111111        101       111111111111111  101
101                        101                        101
101111111111111111111111111101111111111111111111111111101
100000000000000000000000000000000000000000000000000000001
111111111111111111111111111111111111111111111111111111111